R 1000 700

NO ./textures/colorstone.xpm
SO ./textures/colorstone.xpm
WE ./textures/colorstone.xpm
EA ./textures/colorstone.xpm

S ./textures/barrel.xpm
F 205,133,63 
C 221,244,245

11111111111111
100020000000W1
10002000000001
10002000000001
10002000000001
10002000000001
10002000000001
10002000000001
10002000000001
10002000000001
10002000000001
10002000000001
10002000000001
10002000000001
10002000000001
10002000000001
10002000000001
10002000000001
10002000000001
10002000000001
10002000000001
10002000000001
10002000000001
10002000000001
10002000000001
10002000000001
10002000000001
10002000000001
10002000000001
10002000000001
10002000000001
10002000000001
10002000000001
10002000000001
10002000000001
10002000000001
10002000000001
10002000000001
10002000000001
10002000000001
10002000000001
10002000000001
10002000000001
10002000000001
10002000000001
10002000000001
10002000000001
10002000000001
10002000000001
10002000000001
10002000000001
10002000000001
10002000000001
10002000000001
10002000000001
10002000000001
10002000000001
10002000000001
10002000000001
10002000000001
10002000000001
10002000000001
10002000000001
10002000000001
10002000000001
10002000000001
10002000000001
10002000000001
10002000000001
10002000000001
10002000000001
10002000000001
10002000000001
10002000000001
10002000000001
10002000000001
10002000000001
10002000000001
10002000000001
10002000000001
10002000000001
10002000000001
10002000000001
10002000000001
10002000000001
10002000000001
10002000000001
10002000000001
10002000000001
10002000000001
10002000000001
10002000000001
10002000000001
10002000000001
10002000000001
10002000000001
10002000000001
10002000000001
10002000000001
10002000000001
10002000000001
10002000000001
10002000000001
10002000000001
10002000000001
10002000000001
10002000000001
10002000000001
10002000000001
10002000000001
10002000000001
10002000000001
10002000000001
10002000000001
10002000000001
10002000000001
10002000000001
10002000000001
10002000000001
10002000000001
10002000000001
10002000000001
10002000000001
10002000000001
10002000000001
10002000000001
10002000000001
10002000000001
10002000000001
10002000000001
10002000000001
10002000000001
10002000000001
10002000000001
10002000000001
10002000000001
10002000000001
10002000000001
10002000000001
10002000000001
10002000000001
10002000000001
10002000000001
10002000000001
10002000000001
10002000000001
10002000000001
10002000000001
10002000000001
10002000000001
10002000000001
10002000000001
10002000000001
10002000000001
10002000000001
10002000000001
10002000000001
10002000000001
10002000000001
10002000000001
10002000000001
10002000000001
10002000000001
10002000000001
10002000000001
10002000000001
10002000000001
10002000000001
10002000000001
10002000000001
10002000000001
10002000000001
10002000000001
10002000000001
10002000000001
10002000000001
10002000000001
10002000000001
10002000000001
10002000000001
10002000000001
10002000000001
10002000000001
10002000000001
10002000000001
10002000000001
10002000000001
10002000000001
10002000000001
10002000000001
10002000000001
10002000000001
10002000000001
10002000000001
10002000000001
10002000000001
10002000000001
10002000000001
10002000000001
10002000000001
10002000000001
10002000000001
10002000000001
10002000000001
10002000000001
10002000000001
10002000000001
10002000000001
10002000000001
10002000000001
10002000000001
10002000000001
10002000000001
10002000000001
10002000000001
10002000000001
10002000000001
10002000000001
10002000000001
10002000000001
10002000000001
10002000000001
10002000000001
10002000000001
10002000000001
10002000000001
10002000000001
10002000000001
10002000000001
10002000000001
10002000000001
10002000000001
10002000000001
10002000000001
10002000000001
10002000000001
10002000000001
10002000000001
10002000000001
10002000000001
10002000000001
10002000000001
10002000000001
10002000000001
10002000000001
10002000000001
10002000000001
10002000000001
10002000000001
10002000000001
10002000000001
10002000000001
10002000000001
10002000000001
10002000000001
10002000000001
10002000000001
10002000000001
10002000000001
10002000000001
10002000000001
10002000000001
10002000000001
10002000000001
10002000000001
10002000000001
10002000000001
10002000000001
10002000000001
10002000000001
10002000000001
10002000000001
10002000000001
10002000000001
10002000000001
10002000000001
10002000000001
10002000000001
10002000000001
10002000000001
10002000000001
10002000000001
10002000000001
10002000000001
10002000000001
10002000000001
10002000000001
10002000000001
10002000000001
10002000000001
10002000000001
10002000000001
10002000000001
10002000000001
10002000000001
10002000000001
10002000000001
10002000000001
10002000000001
10002000000001
10002000000001
10002000000001
10002000000001
10002000000001
10002000000001
10002000000001
10002000000001
10002000000001
10002000000001
10002000000001
10002000000001
10002000000001
10002000000001
10002000000001
10002000000001
10002000000001
10002000000001
10002000000001
10002000000001
10002000000001
10002000000001
10002000000001
10002000000001
10002000000001
10002000000001
10002000000001
10002000000001
10002000000001
10002000000001
10002000000001
10002000000001
10002000000001
10002000000001
10002000000001
10002000000001
10002000000001
10002000000001
10002000000001
10002000000001
10002000000001
10002000000001
10002000000001
10002000000001
10002000000001
10002000000001
10002000000001
10002000000001
10002000000001
10002000000001
10002000000001
10002000000001
10002000000001
10002000000001
10002000000001
10002000000001
10002000000001
10002000000001
10002000000001
10002000000001
10002000000001
10002000000001
10002000000001
10002000000001
10002000000001
10002000000001
10002000000001
10002000000001
10002000000001
10002000000001
10002000000001
10002000000001
10002000000001
10002000000001
10002000000001
10002000000001
10002000000001
10002000000001
10002000000001
10002000000001
10002000000001
10002000000001
10002000000001
10002000000001
10002000000001
10002000000001
10002000000001
10002000000001
10002000000001
10002000000001
10002000000001
10002000000001
10002000000001
10002000000001
10002000000001
10002000000001
10002000000001
10002000000001
10002000000001
10002000000001
10002000000001
10002000000001
10002000000001
11111111111111