R 1000 700

NO ./textures/Bricks.png
SO ./textures/Bricks.png
WE ./textures/bookshelf.png
EA ./textures/bookshelf.png

S ./textures/barrel.xpm
F 205,133,63 
C 221,244,245


                                                                                                                           11111111111111111111111
                                                                                                                           10000000000000000000001
                                                                                                     111111111111111111111110000000000000000000001
                                                                                                     100000000000000000000000000000000000000000001
                                                                                             11111111100000000000000000000000000000000000000000001111111111111
                                                                                             10000000000000000000000000000000000000000000000000000000000000001           
                                                                                             10000000000000000000000000000000000000000000000000000000000000001           
                                          111111111111                 111111111111111111111110000000000000000000000000000000000000000000000000000000000000001           
                                          100000000001                 100000000000000000000000000000000000000000000000000000000000000000000000000000000000001           
    1111111111111111111111111111111111111110000000000111111111111111111100000000000000000000000000000000000000000000000000000000000000000000000000000000000001           
    1000000000000000000000000000000000000000000000000000000000000000000000000000000000000000000000000000000000000000000000000000000000000000000000000000000001           
    1111111110000000000000000000000000000000000000000000000000000000000000000000000000000000000000000000000000000000000000000000000000000000000000000000000001                                                                                                                                                1           
            10000000000000000000000000000000000000000000000000000000000000000000000000000000000000000000000000000000000000000000000000000000000000000000000001                                                                                                                                                1           
            10000000000000000000000000000000000000000000000000000000000000000000000000000000000000000000000000000000000000000000000000000000000000000000000001           
            11111110000000000000000000000000000000000000000000000000000000000000000000000000000000000000000000000000000000000000000000000000000000000000000001              
                  10000000000000000000000000000000000000000000000000000000000000000000000000000000000000000000000000000000000000000000000000000000000000000001
                  100000000000000000000000000000000000000000000000000000000000000000000000000000000000000000000000000000000000000000000000000000000000000000011
                  1000000000000000000000000000000000000000000000000000000000000000000000000000000000000000000000000000000111111111000000000000000000000000000011
           111111110000000000000000000000000000000000000000000000000000000000000000000000000000000000000000000000000000001       100000000000000000000000000000011
           10000000000000000000000000000000000000000000000000000000000000000000000000000000000000000000000000000011111111        11111111111111111111111111111111       
           1000000000000000000000000000000000000000000000000000000000000000000000000000000000000000000000000000001      
           1000000000000000000000000000000000000000000000000000000000000000000000000000000000000000000000000000001       
           10000000000000000000000000000000000000000000000000000000000000000000000000000000000000000000000000000011111  
           11111111100000000000000000000000000000000000000000000000000000000000000000000000000000000000000000000000001   
                   100000000000000000000111111111111111111111110000000000000000000000000000000000000000000000000000001    
                   1111100000000000000001                     11110000000000000000000000000000000000000000000000011111     
                       100000000000000001                        1000000000000000000000000000000000000000000000001      
                       111110000001111111                        1111110000000000000000000000000000000000000000001          
                           10000001                                   10000000000000000000000000000000000000000001      
                           10000001                                   10000000000000000000000000000000000000000001      
                           11111111                                   10000000000000000000000000000000000000000001      
                                                                      10000000000000000000000000000000000000000001      
                                                                      100000000000000000000000000000000020000000011
                                                                      1000000000000022000000000000000000000000000001111
                                                                      1000000000000000000000000000000000000000000000001
                                                                      1000000000000000000000000000000002000000000000001111
                                                                      1000000000000000000000000000000000000000000000000001
                                                                      100000000000000000000000000000000000000000000000000111111111111111
                                                                      100000000000000000000000000000000000000000000000000000000000000111
                                                                      111111100000000000000000000000000000000000000020000000000000000111
                                                                            1000000000000000000000000000000000000000000000000000000001
                                                                            1000000000002200000000000000000000000000000000000000000001
                                                                            1000000000000000000000000000000000000000000000000000000001
                                                                            1111100000000000000000000000000000000000000000000000000001
                                                                                1000000000000000000000000000000000000000000000000000011111111
                                                                                1000000000000000000000000000000000000000000000000000000000001
                                                                                1111111110000000000000000000000000000000000000000000000000001
                                                                                        1000000000000000000000000000000000000000000000000000111111111111111
                                                                                        1000000000000000000000000000000000000000000000000000000000000000001111111
                                                                                        1111111111111100000000000000000000000000000000000000000000000000000000001
                                                                                                     10000000000000000000000000000000000000000000000000200000000111111
                                                                                                     11111111100000000000000000000000000000000000000000000000000000001
                                                                                                             100000000000000000000000000200000000000000000000000000001111111 
                                                                                                             100000000000000000000000000000000000000000000000000000000000001
                                                                                                             100000000000000000000000000000000011111100000000000000000000001
                                                                                                             10000000000000000000000000000000001    100000000000000020000001
                                                                                                             11110000000000002200000000000000001    111111111111110000000001
                                                                                                                10000000000000000000000000000111                 10000000001
                                                                                                                111111111000000000000000000001                   11111100001
                                                                                                                        1000000000000000000001                        100001
                                                                                                                        1111000000000000000001111                     100001
                                                                                                                           1000000000000000000001                     111111
                                                                                                                           1000000000000000000001        
                                                                                                                           1000000000000000000001        
                                                                                                                           1111000000000000011111            
                                                                                                                              100000000001111               
                                                                                                                           111100000000001               
                                                                                                                           100000000001111               
                                                                                                                           100000000001                  
                                                                                                                           100000011111                      
                                                                             11111111                         111111111111110000001                          
                                                                             10000001                         100000000000000000001
                                                                        11111100000011111111111111111111111111100000000000111111111
                                                                        100000000000000000000000000000000000000000000000001
                                                                        100000000000000002000000000000000000000200000011111
                                                                        10000000000000000000000000000000000000000000001
                                                                        11111111100000000000000000000000000000000000001
                                                                                1000000000000000000000000N0000000000001
                                                                                111111111111100000000000000000000000001
                                                                                            1000000000000000000000000011111
                                                                                            1111000000000002000000000000001
                                                                                               1000000000000000000000000001
                                                                                               1111111111111111100000000001
                                                                                                               111000000111
                                                                                                                  1000001
                                                                                                                  1111111