R 1000 700


NO ./textures/colorstone.xpm
SO ./textures/colorstone.xpm
WE ./textures/colorstone.xpm
EA ./textures/colorstone.xpm

S ./textures/barrel.xpm
F 205,133,63 
C 221,244,245


1111111111111111111111111111111111111111111111111111111111
1221221221221010101010101010112212212212210101010101010101
1001001001001000100010001000110010010010010001000100010001
1001001001001010101010101010110010010010010101010101010101
1000000000000000100000000000110000000000000001000000000001
1010101000000000001010101010110101010000000000010101010101
1010101010000000101010101010110101010100000001010101010101
1010101010000000101010101010110101010100000001010101010101
1000000000000000000000000000110000000000000000000000000001
10000000100000001000000000001100000001000N0001000000000001
1000000000000000000000000000110000000000000000000000000001
1010101010000000101010101010110101010100000001010101010101
1010101010000000101010101010110101010100000001010101010101
1010101000000000001010101010110101010000000000010101010101
1000000010000000100000000000110000000100000001000000000001
1010101010101010101010101010110101010101010101010101010101
1000100010001000100010001000110001000100010001000100010001
1010101010101010101010101010110101010101010101010101010101
1111111111111111111111111111111111111111111111111111111111