R 1000 700


NO ./textures/colorstone.xpm
SO ./textures/colorstone.xpm
WE ./textures/colorstone.xpm
EA ./textures/colorstone.xpm

S ./textures/barrel.xpm
F 205,133,63 
C 221,244,245


11111111111111111111111111111
12212212212210101010101010101
10010010010010001000100010001
10010010010010101010101010101
10000000000000001000000000001
10101010000000000010101010101
10101010100000001010101010101
10101010100000001010101010101
10000000000000000000000000001
100000001000N0001000000000001
10000000000000000000000000001
10101010100000001010101010101
10101010100000001010101010101
10101010000000000010101010101
10000000100000001000000000001
10101010101010101010101010101
10001000100010001000100010001
10101010101010101010101010101
11111111111111111111111111111